EA /Users/kpeanuts/Desktop/cubik_nash/image/4.xpm
WE /Users/kpeanuts/Desktop/cubik_nash/image/4.xpm
NO /Users/kpeanuts/Desktop/cubik_nash/image/4.xpm
SO /Users/kpeanuts/Desktop/cubik_nash/image/4.xpm

C 209,183,152

F 115, 70, 70

11111
10001
10S01
10001
11111